11111111
1E10PC11
10110C11
1C010C11
1100C011
11111111